#####.............#####
#.....................#
#.....................#
#.....................#
#.....................#
.......................
.......................
.......................
.......................
.......................
.......................
.......................
.......................
.......................
.......................
.......................
.......................
.......................
#.....................#
#.....................#
#.....................#
#.....................#
#####.............#####
